ABCD
50
20
5
5
200
11111111111111111111111111111111111111111111111111
2                                                3
2                                                3
2                                                3
2                                                3
2                                                3
2                                                3
2                                                3
2                                                3
2                                                3
2                                                3
2                                                3
2                                                3
2                                                3
2                                                3
2                                                3
2                                                3
2                                                3
2                                                3
44444444444444444444444444444444444444444444444444
